@.#########
#.........#
#########.#
#.........#
#.#########
#.........#
#########.#
#.........#
#.#########
#.........#
#########..