@..###.#.##
##.....#..#
.##..###..#
##........#
#..###.#..#
#.....##..#
.##..#....#
.##.##.#.##
.#......##.
.#.....##..
.####.##...